januar	january
january	januar
februar	february
february	februar
mars	masch<br>march
march	mars<br>masch
april	april
april	april
mai	may
may	mai
juni	j端ni<br>june
june	juni<br>j端ni
juli	j端li<br>july
july	juli<br>j端li
august	august
august	august
september	september
september	september
oktober	octobre
octobre	oktober
november	nuvember<br>november
november	november<br>nuvember
desember	december
december	desember
